,negative_sum,positive_sum,total_sum,sentiment_score,average_score
2020-02-01,0,0,0,0.0,0.5
2020-02-02,0,0,0,0.0,0.5
2020-02-03,0,0,0,0.0,0.5
2020-02-04,0,0,0,0.0,0.5
2020-02-05,0,0,0,0.0,0.5
2020-02-06,0,0,0,0.0,0.5
2020-02-07,0,0,0,0.0,0.5
2020-02-08,0,0,0,0.0,0.5
2020-02-09,0,0,0,0.0,0.5
2020-02-10,0,0,0,0.0,0.5
2020-02-11,0,0,0,0.0,0.5
2020-02-12,0,0,0,0.0,0.5
2020-02-13,0,0,0,0.0,0.5
2020-02-14,0,0,0,0.0,0.5
2020-02-15,0,0,0,0.0,0.5
2020-02-16,0,0,0,0.0,0.5
2020-02-17,17,5,22,6.257513395510614,0.2844324270686643
2020-02-18,21,15,36,13.528070231433958,0.3757797286509433
2020-02-19,12,9,21,10.051853104960173,0.47865967166477014
2020-02-20,13,14,27,14.532641844823956,0.5382459942527391
2020-02-21,16,7,23,8.763383042765781,0.3810166540332948
2020-02-22,14,8,22,8.574786862358451,0.3897630391981114
2020-02-23,26,13,39,13.047149813268334,0.33454230290431625
2020-02-24,94,34,128,33.65071926312521,0.2628962442431657
2020-02-25,22,15,37,13.138394202105701,0.35509173519204595
2020-02-26,16,15,31,14.33266672026366,0.46234408775044067
2020-02-27,13,13,26,11.74389800755307,0.45168838490588736
2020-02-28,84,15,99,19.40750984661281,0.196035452996089
2020-02-29,34,6,40,9.414192384108901,0.23535480960272254
2020-03-01,20,20,40,18.620588583871722,0.46551471459679306
2020-03-02,20,25,45,22.97229437623173,0.5104954305829273
2020-03-03,33,31,64,28.688180002383888,0.44825281253724825
2020-03-04,113,28,141,50.72930488316342,0.3597823041359108
2020-03-05,43,43,86,43.08102933410555,0.5009422015593669
2020-03-06,16,32,48,29.49070420768112,0.6143896709933566
2020-03-07,81,297,378,233.7974220458418,0.618511698533973
2020-03-08,36,57,93,47.863076710375026,0.5146567388212369
2020-03-09,17,94,111,75.92042038915679,0.6839677512536647
2020-03-10,32,20,52,20.27733078505844,0.3899486689434315
2020-03-11,36,33,69,30.09271968808025,0.43612637229101814
2020-03-12,30,29,59,26.705855131847784,0.4526416124041997
2020-03-13,23,28,51,26.601505185477436,0.5215981408917144
2020-03-14,14,27,41,23.073779238387942,0.5627751033753157
2020-03-15,11,31,42,27.174348135478795,0.6470082889399713
2020-03-16,18,15,33,15.39059550408274,0.4663816819419012
2020-03-17,1,4,5,3.8849643766880035,0.7769928753376008
2020-03-18,3,3,6,2.6991030424833298,0.44985050708055496
2020-03-19,2,4,6,4.066537857055664,0.6777563095092773
2020-03-20,1,7,8,5.818388197571039,0.7272985246963799
2020-03-21,0,1,1,0.7609480619430542,0.7609480619430542
2020-03-22,2,3,5,2.6164027438499033,0.5232805487699806
2020-03-23,1,9,10,7.367989337071776,0.7367989337071776
2020-03-24,19,23,42,19.94417029293254,0.47486119745077476
2020-03-25,17,15,32,15.27890160214156,0.4774656750669237
2020-03-26,93,16,109,28.688420431688428,0.26319651772191216
2020-03-27,24,15,39,15.889480989426374,0.4074225894724711
2020-03-28,13,12,25,11.348265431355685,0.4539306172542274
2020-03-29,0,0,0,0.0,0.5
2020-03-30,7,13,20,10.4311778023839,0.521558890119195
2020-03-31,11,16,27,14.29174542799592,0.5293239047405897
2020-04-01,10,16,26,14.522929057944566,0.5585741945363295
2020-04-02,7,19,26,16.273316339123994,0.6258967822739998
2020-04-03,15,23,38,21.506220132578164,0.5659531613836359
2020-04-04,8,9,17,8.504010018892586,0.5002358834642697
2020-04-05,4,29,33,23.698319107294083,0.7181308820392146
2020-04-06,4,8,12,7.647493978962302,0.6372911649135252
2020-04-07,4,9,13,8.037335570901632,0.6182565823770486
2020-04-08,16,8,24,8.379953453317285,0.3491647272215535
2020-04-09,17,18,35,19.463463809341192,0.5560989659811769
2020-04-10,9,15,24,13.942343924194574,0.5809309968414406
2020-04-11,8,43,51,33.77793143130839,0.6623123810060468
2020-04-12,5,10,15,8.037124121561646,0.5358082747707764
2020-04-13,9,12,21,11.277955301571637,0.5370454905510303
2020-04-14,4,4,8,3.5472502317279577,0.4434062789659947
2020-04-15,7,8,15,7.46506221499294,0.4976708143328627
2020-04-16,6,7,13,6.75484107225202,0.5196031594040016
2020-04-17,8,12,20,11.56141159683466,0.5780705798417329
2020-04-18,5,31,36,28.40858055651188,0.7891272376808856
2020-04-19,4,11,15,9.802261502481997,0.6534841001654664
2020-04-20,10,3,13,3.7260785116814077,0.2866214239754929
2020-04-21,6,5,11,5.498080722987652,0.4998255202716047
2020-04-22,9,6,15,6.1193562634289265,0.4079570842285951
2020-04-23,6,4,10,4.8269012132659554,0.48269012132659556
2020-04-24,8,3,11,3.213730658404529,0.2921573325822299
2020-04-25,6,12,18,11.23172803223133,0.6239848906795183
2020-04-26,6,21,27,17.401147501543164,0.6444869445015987
2020-04-27,4,4,8,4.844475228339434,0.6055594035424292
2020-04-28,7,11,18,9.638001170940697,0.5354445094967054
2020-04-29,14,8,22,8.1351750921458,0.3697806860066273
2020-04-30,8,4,12,4.674566583940759,0.3895472153283966
2020-05-01,32,11,43,19.802263408666477,0.46051775368991804
2020-05-02,26,3,29,12.183702459558845,0.4201276710192705
2020-05-03,7,7,14,6.8515292182564735,0.4893949441611767
2020-05-04,4,4,8,4.406239356845617,0.5507799196057022
2020-05-05,6,5,11,5.033478487282991,0.45758895338936284
2020-05-06,2,3,5,3.4408120810985565,0.6881624162197113
2020-05-07,3,5,8,4.573713701218367,0.5717142126522958
2020-05-08,2,6,8,5.02054581604898,0.6275682270061225
2020-05-09,4,3,7,2.5142463746014982,0.3591780535144998
2020-05-10,2,41,43,28.47484604269266,0.6622057219230851
2020-05-11,4,31,35,23.798674484714866,0.6799621281347105
2020-05-12,1,6,7,5.022177577018738,0.7174539395741054
2020-05-13,3,11,14,8.231734450906515,0.5879810322076082
2020-05-14,4,7,11,4.8932592030614614,0.4448417457328601
2020-05-15,8,5,13,5.066550323739648,0.38973464028766525
2020-05-16,7,10,17,9.595554625615478,0.5644443897420869
2020-05-17,1,5,6,3.5600245939567685,0.5933374323261281
2020-05-18,1,3,4,2.8032696545124054,0.7008174136281013
2020-05-19,6,10,16,8.074873636011034,0.5046796022506896
2020-05-20,6,3,9,3.331526991445571,0.3701696657161746
2020-05-21,6,5,11,4.4702216647565365,0.40638378770513967
2020-05-22,12,25,37,20.653359359130263,0.5581989015981152
2020-05-23,5,26,31,22.28822156507522,0.7189748891959747
2020-05-24,0,2,2,1.8601222038269043,0.9300611019134521
2020-05-25,3,5,8,4.426541698165238,0.5533177122706547
2020-05-26,7,7,14,7.4791215024888515,0.5342229644634894
2020-05-27,1,5,6,4.265828736126423,0.7109714560210705
2020-05-28,11,4,15,5.819158146623522,0.38794387644156814
2020-05-29,11,5,16,5.230644427239895,0.32691527670249343
2020-05-30,3,3,6,3.102056817151606,0.5170094695252677
2020-05-31,4,9,13,7.318561101332307,0.5629662385640236
2020-06-01,5,1,6,1.0581426844000816,0.17635711406668028
2020-06-02,41,20,61,21.706698031164706,0.3558475087076181
2020-06-03,14,7,21,8.11800775444135,0.3865717978305405
2020-06-04,1,8,9,6.376041773706675,0.7084490859674083
2020-06-05,4,5,9,4.5998228043317795,0.511091422703531
2020-06-06,3,10,13,8.599908234085888,0.6615314026219914
2020-06-07,11,6,17,6.000375563278794,0.3529632684281644
2020-06-08,0,3,3,2.3013641834259033,0.7671213944753011
2020-06-09,5,1,6,1.590500494465232,0.2650834157442053
2020-06-10,2,9,11,7.231141727417707,0.657376520674337
2020-06-11,3,7,10,6.642453555949032,0.6642453555949033
2020-06-12,3,1,4,1.155365092214197,0.28884127305354923
2020-06-13,4,5,9,4.121205596253276,0.45791173291703063
2020-06-14,1,5,6,3.6153315752744675,0.6025552625457445
2020-06-15,5,6,11,5.6139256209135056,0.5103568746285005
2020-06-16,6,11,17,9.666959666647017,0.568644686273354
2020-06-17,11,21,32,18.824397183023393,0.588262411969481
2020-06-18,7,8,15,7.194303636439145,0.4796202424292763
2020-06-19,2,5,7,4.604715570807457,0.657816510115351
2020-06-20,7,14,21,11.22460569255054,0.5345050329785972
2020-06-21,5,11,16,8.912258608266711,0.5570161630166695
2020-06-22,7,14,21,12.530163835734129,0.5966744683682919
2020-06-23,3,48,51,37.938813677057624,0.7438983073932868
2020-06-24,5,12,17,10.114758608862758,0.5949858005213386
2020-06-25,5,12,17,10.581304050981998,0.6224296500577646
2020-06-26,2,6,8,5.652107177302241,0.7065133971627802
2020-06-27,23,16,39,13.922234384343028,0.3569803688293084
2020-06-28,4,5,9,4.90319880284369,0.5447998669826322
2020-06-29,4,4,8,3.8470498844981194,0.4808812355622649
2020-06-30,1,5,6,3.566393859218806,0.5943989765364677
2020-07-01,7,12,19,9.146639252081513,0.481402065899027
2020-07-02,31,5,36,18.52137318253517,0.5144825884037547
2020-07-03,10,13,23,13.800581630319357,0.6000252882747547
2020-07-04,5,8,13,7.957138389348984,0.6120875684114603
2020-07-05,0,12,12,8.782897591590881,0.7319081326325735
2020-07-06,5,15,20,12.48775839805603,0.6243879199028015
2020-07-07,2,33,35,23.939156353473663,0.6839758958135332
2020-07-08,17,103,120,67.65187383815646,0.5637656153179705
2020-07-09,8,23,31,16.801623553037643,0.5419878565496014
2020-07-10,8,10,18,8.55417901929468,0.4752321677385933
2020-07-11,4,9,13,7.5983977587893605,0.5844921352914892
2020-07-12,3,10,13,7.918610063381493,0.6091238510293456
2020-07-13,4,6,10,5.54871679097414,0.554871679097414
2020-07-14,5,9,14,7.544039347209036,0.538859953372074
2020-07-15,3,1,4,1.2757759056985378,0.31894397642463446
2020-07-16,2,6,8,5.781451642513275,0.7226814553141594
2020-07-17,5,11,16,10.417454664129764,0.6510909165081102
2020-07-18,6,5,11,4.700536482967436,0.4273214984515851
2020-07-19,1,9,10,8.111345380544662,0.8111345380544662
2020-07-20,3,7,10,5.950629163533449,0.595062916353345
2020-07-21,4,5,9,4.72803471237421,0.5253371902638011
2020-07-22,5,2,7,2.437066499143839,0.3481523570205484
2020-07-23,6,8,14,6.957959558814764,0.4969971113439117
2020-07-24,6,15,21,12.722557056229562,0.6058360502966458
2020-07-25,4,36,40,28.23275052756071,0.7058187631890178
2020-07-26,17,21,38,19.584800710901618,0.5153894923921478
2020-07-27,4,5,9,4.733257303014398,0.5259174781127108
2020-07-28,1,2,3,1.588820131495595,0.5296067104985317
2020-07-29,3,11,14,8.659647732973099,0.6185462666409356
2020-07-30,1,9,10,7.36712047085166,0.736712047085166
2020-07-31,2,2,4,2.4827084690332413,0.6206771172583103
2020-08-01,3,10,13,8.416512864641845,0.6474240665109112
2020-08-02,2,22,24,16.2549678273499,0.6772903261395792
2020-08-03,6,4,10,4.323877791874111,0.43238777918741106
2020-08-04,1,12,13,8.546352218836546,0.6574117091412728
2020-08-05,4,2,6,1.9880380146205425,0.3313396691034238
2020-08-06,2,4,6,3.024263712577522,0.5040439520962536
2020-08-07,3,16,19,12.602460608584806,0.6632874004518319
2020-08-08,2,10,12,7.290197394788265,0.6075164495656887
2020-08-09,3,12,15,9.523880982305855,0.6349253988203903
2020-08-10,3,12,15,10.150739507749677,0.6767159671833117
2020-08-11,1,1,2,0.8109821602702141,0.40549108013510704
2020-08-12,3,5,8,4.528463579714298,0.5660579474642873
2020-08-13,3,3,6,3.0529059432446957,0.5088176572074493
2020-08-14,0,3,3,2.4668691158294678,0.8222897052764893
2020-08-15,6,4,10,4.481515452265739,0.44815154522657397
2020-08-16,1,0,1,0.020667219534516335,0.020667219534516335
2020-08-17,1,5,6,4.697005420923233,0.7828342368205389
2020-08-18,5,2,7,2.4421499436721206,0.3488785633817315
2020-08-19,5,89,94,75.72830782365054,0.8056202959962824
2020-08-20,22,21,43,22.450550563633442,0.5221058270612429
2020-08-21,3,6,9,5.5367152988910675,0.6151905887656741
2020-08-22,2,6,8,4.85558208823204,0.606947761029005
2020-08-23,2,2,4,1.7769740223884583,0.44424350559711456
2020-08-24,4,2,6,1.9024464637041092,0.31707441061735153
2020-08-25,4,0,4,0.9644324705004692,0.2411081176251173
2020-08-26,4,2,6,1.7555106189101934,0.2925851031516989
2020-08-27,4,1,5,0.9734550546854734,0.19469101093709468
2020-08-28,2,5,7,4.434984430670738,0.6335692043815341
2020-08-29,5,2,7,1.759465305134654,0.2513521864478077
2020-08-30,4,5,9,4.697295116260648,0.5219216795845164
2020-08-31,3,5,8,4.7686395812779665,0.5960799476597458
2020-09-01,0,1,1,0.6911791563034058,0.6911791563034058
2020-09-02,3,2,5,2.077145516872406,0.4154291033744812
2020-09-03,6,7,13,6.738412333652377,0.5183394102809521
2020-09-04,61,12,73,28.001036407426,0.38357584119761645
2020-09-05,42,8,50,14.998521078377962,0.29997042156755926
2020-09-06,17,6,23,7.893552340567112,0.343197927850744
2020-09-07,5,3,8,3.9278552355244756,0.49098190444055945
2020-09-08,0,2,2,1.5484315156936646,0.7742157578468323
2020-09-09,1,4,5,3.258594728074968,0.6517189456149936
2020-09-10,4,6,10,5.277331626042724,0.5277331626042724
2020-09-11,3,1,4,1.1665044017136097,0.2916261004284024
2020-09-12,2,3,5,2.642469512298703,0.5284939024597406
2020-09-13,4,2,6,2.107949231751263,0.35132487195854384
2020-09-14,1,3,4,2.6129159033298492,0.6532289758324623
2020-09-15,4,5,9,4.242018434219062,0.4713353815798958
2020-09-16,2,9,11,6.871827946975827,0.624711631543257
2020-09-17,3,6,9,4.640763363335282,0.5156403737039201
2020-09-18,0,5,5,4.268344759941101,0.8536689519882202
2020-09-19,1,1,2,1.0640780478715897,0.5320390239357948
2020-09-20,2,2,4,2.1542834378778934,0.5385708594694734
2020-09-21,3,8,11,7.199774460867047,0.6545249509879134
2020-09-22,0,1,1,0.9048445224761963,0.9048445224761963
2020-09-23,3,4,7,3.91292904317379,0.5589898633105415
2020-09-24,2,7,9,6.753407992422581,0.7503786658247312
2020-09-25,4,5,9,4.072998950257897,0.45255543891754413
2020-09-26,5,6,11,4.969012729823589,0.4517284299839627
2020-09-27,2,8,10,7.006402734667063,0.7006402734667063
2020-09-28,3,5,8,4.91697334498167,0.6146216681227088
2020-09-29,2,3,5,2.550764285027981,0.5101528570055962
2020-09-30,3,3,6,3.1329522635787725,0.5221587105964621
2020-10-01,3,7,10,6.477318592369556,0.6477318592369556
2020-10-02,8,6,14,5.5870644096285105,0.39907602925917934
2020-10-03,5,3,8,3.0861752405762672,0.3857719050720334
2020-10-04,5,1,6,1.0640724282711744,0.17734540471186241
2020-10-05,1,5,6,4.671042717993259,0.7785071196655432
2020-10-06,2,5,7,5.1567816734313965,0.7366830962044852
2020-10-07,2,2,4,1.8935106191784143,0.4733776547946036
2020-10-08,1,2,3,2.1711223125457764,0.7237074375152588
2020-10-09,1,3,4,2.6430753618478775,0.6607688404619694
2020-10-10,3,6,9,5.864222053438425,0.651580228159825
2020-10-11,5,1,6,1.1851922208443284,0.19753203680738807
2020-10-12,4,6,10,5.744887202978134,0.5744887202978134
2020-10-13,7,5,12,5.02203866513446,0.41850322209453833
2020-10-14,3,4,7,3.6876448318362236,0.526806404548032
2020-10-15,4,3,7,3.319549895823002,0.4742214136890003
2020-10-16,2,6,8,5.618503451347351,0.7023129314184189
2020-10-17,2,5,7,4.589191944338381,0.6555988491911974
2020-10-18,9,4,13,4.977596443146467,0.3828920340881898
2020-10-19,5,3,8,3.0089895967394114,0.3761236995924264
2020-10-20,5,3,8,3.5406122095882893,0.44257652619853616
2020-10-21,5,11,16,9.50159008614719,0.5938493803841993
2020-10-22,4,18,22,14.834787552244961,0.6743085251020436
2020-10-23,2,5,7,4.535663537681103,0.6479519339544433
2020-10-24,3,5,8,4.462399081327021,0.5577998851658776
2020-10-25,3,6,9,5.904550813138485,0.6560612014598317
2020-10-26,2,8,10,6.742534942924976,0.6742534942924976
2020-10-27,4,6,10,4.682993486523628,0.46829934865236283
2020-10-28,0,7,7,5.938256502151489,0.8483223574502128
2020-10-29,3,13,16,11.774002395570278,0.7358751497231424
2020-10-30,2,6,8,5.125637111254036,0.6407046389067546
2020-10-31,6,10,16,8.962422058917582,0.5601513786823489
2020-11-01,2,2,4,1.5049426881596446,0.37623567203991115
2020-11-02,0,4,4,3.140172839164734,0.7850432097911835
2020-11-03,1,0,1,0.35320988297462463,0.35320988297462463
2020-11-04,2,2,4,1.5165632525458932,0.3791408131364733
2020-11-05,2,2,4,1.3361211456358433,0.3340302864089608
2020-11-06,2,1,3,0.9112373879179358,0.3037457959726453
2020-11-07,0,2,2,1.7737257480621338,0.8868628740310669
2020-11-08,1,1,2,0.6408334840089083,0.32041674200445414
2020-11-09,5,2,7,2.1155408304184675,0.3022201186312096
2020-11-10,36,12,48,13.17412848258391,0.27446101005383144
2020-11-11,9,9,18,7.421583557501435,0.41231019763896865
2020-11-12,10,4,14,5.394168183207512,0.38529772737196516
2020-11-13,6,11,17,8.722859339788556,0.5131093729287386
2020-11-14,7,6,13,5.134319743141532,0.3949476725493486
2020-11-15,2,1,3,0.8805033322423697,0.29350111074745655
2020-11-16,3,3,6,2.8434542324393988,0.4739090387398998
2020-11-17,9,3,12,5.18321219086647,0.43193434923887253
2020-11-18,2,4,6,3.3961088359355927,0.5660181393225988
2020-11-19,0,3,3,2.6385592818260193,0.8795197606086731
2020-11-20,11,1,12,2.3663112241774797,0.19719260201478997
2020-11-21,15,9,24,10.717388144694269,0.4465578393622612
2020-11-22,11,12,23,10.848026541993022,0.47165332791274006
2020-11-23,8,16,24,11.793594177812338,0.4913997574088474
2020-11-24,13,28,41,19.879886373877525,0.48487527741164693
2020-11-25,0,9,9,6.984094560146332,0.7760105066829257
2020-11-26,0,7,7,5.328576564788818,0.7612252235412598
2020-11-27,1,1,2,0.6836146339774132,0.3418073169887066
2020-11-28,4,5,9,5.187058305367827,0.5763398117075363
2020-11-29,2,4,6,3.505749956704676,0.5842916594507793
2020-11-30,1,4,5,3.759194500744343,0.7518389001488686
2020-12-01,2,3,5,2.3665628787130117,0.4733125757426023
2020-12-02,1,1,2,0.8900135736912489,0.44500678684562445
2020-12-03,1,4,5,3.328499408904463,0.6656998817808926
2020-12-04,2,7,9,6.170759551227093,0.6856399501363436
2020-12-05,1,3,4,2.4861760400235653,0.6215440100058913
2020-12-06,2,5,7,3.930642243474722,0.5615203204963889
2020-12-07,2,6,8,5.523182205855846,0.6903977757319808
2020-12-08,4,6,10,5.826353877782822,0.5826353877782822
2020-12-09,3,1,4,1.620282819494605,0.40507070487365127
2020-12-10,1,0,1,0.3954496383666992,0.3954496383666992
2020-12-11,5,2,7,1.6056849418673664,0.22938356312390948
2020-12-12,10,2,12,2.660622587893158,0.22171854899109653
2020-12-13,5,2,7,1.996772582642734,0.28525322609181913
2020-12-14,4,3,7,2.4443868035450578,0.3491981147921511
2020-12-15,1,5,6,3.7074911892414093,0.6179151982069016
2020-12-16,1,6,7,4.989728540182114,0.7128183628831591
2020-12-17,4,0,4,0.5131698339246213,0.12829245848115534
2020-12-18,7,0,7,1.609652392566204,0.22995034179517201
2020-12-19,2,2,4,2.723629117012024,0.680907279253006
2020-12-20,4,3,7,2.7277986286208034,0.38968551837440046
2020-12-21,4,5,9,3.8927783584222198,0.43253092871357995
2020-12-22,2,0,2,0.10343899577856064,0.05171949788928032
2020-12-23,3,11,14,8.363380264490843,0.5973843046064887
2020-12-24,4,6,10,4.578797470778227,0.4578797470778227
2020-12-25,4,4,8,4.324554628226906,0.5405693285283633
2020-12-26,2,6,8,4.549420520663261,0.5686775650829077
2020-12-27,8,19,27,15.98399726068601,0.5919998985439263
2020-12-28,10,3,13,3.140329955611378,0.24156384273933676
2020-12-29,4,5,9,4.611914902925491,0.5124349892139435
2020-12-30,3,2,5,2.0474860444664955,0.4094972088932991
2020-12-31,3,2,5,1.8429529294371605,0.3685905858874321
2021-01-01,4,9,13,8.406884338706732,0.6466834106697485
2021-01-02,16,8,24,10.08400822430849,0.4201670093461871
2021-01-03,13,2,15,2.4669918045401573,0.16446612030267715
2021-01-04,2,2,4,1.4579301942139864,0.3644825485534966
2021-01-05,1,2,3,1.7881688326597214,0.5960562775532404
2021-01-06,1,1,2,1.0242027193307877,0.5121013596653938
2021-01-07,4,1,5,1.7347265481948853,0.3469453096389771
2021-01-08,5,2,7,2.118280664086342,0.30261152344090597
2021-01-09,5,4,9,3.868507022038102,0.4298341135597891
2021-01-10,6,5,11,5.01103690918535,0.4555488099259409
2021-01-11,6,2,8,2.1850711363367736,0.2731338920420967
2021-01-12,14,32,46,25.78274125792086,0.5604943751721926
2021-01-13,58,35,93,39.53824600856751,0.42514243019965064
2021-01-14,5,5,10,5.042299618013203,0.5042299618013203
2021-01-15,6,4,10,3.920254989527166,0.3920254989527166
2021-01-16,3,4,7,4.071327775716782,0.5816182536738259
2021-01-17,3,12,15,11.27164163440466,0.7514427756269773
2021-01-18,116,30,146,35.700436022598296,0.24452353440135818
2021-01-19,1,1,2,0.9965161979198456,0.4982580989599228
2021-01-20,1,3,4,2.5218099914491177,0.6304524978622794
2021-01-21,16,8,24,8.926479106768966,0.3719366294487069
2021-01-22,19,5,24,7.364820124814287,0.3068675052005953
2021-01-23,10,2,12,3.6197422575205564,0.30164518812671304
2021-01-24,9,12,21,10.818791831843555,0.5151805634211216
2021-01-25,20,4,24,5.906481419689953,0.24610339248708138
2021-01-26,10,4,14,4.869727113284171,0.3478376509488693
2021-01-27,14,7,21,7.807426316197962,0.37178220553323627
2021-01-28,2,5,7,4.78085021674633,0.6829786023923329
2021-01-29,8,4,12,4.53022193768993,0.37751849480749416
2021-01-30,2,1,3,0.8213241538032889,0.27377471793442965
2021-01-31,5,3,8,2.5156122650951147,0.31445153313688934
2021-02-01,4,1,5,1.6448835590854287,0.32897671181708577
2021-02-02,5,2,7,1.8881443068385124,0.26973490097693037
2021-02-03,5,6,11,5.341286175884306,0.48557147053493693
2021-02-04,6,8,14,7.315762034617364,0.5225544310440975
2021-02-05,7,4,11,3.552640713751316,0.322967337613756
2021-02-06,1,7,8,6.590089440345764,0.8237611800432205
2021-02-07,3,3,6,2.772029511164874,0.462004918527479
2021-02-08,4,3,7,3.0726667251437902,0.43895238930625574
2021-02-09,4,2,6,1.889865733217448,0.314977622202908
2021-02-10,6,3,9,3.131378434598446,0.3479309371776051
2021-02-11,2,0,2,0.026863774750381708,0.013431887375190854
2021-02-12,3,0,3,0.5578594347462058,0.18595314491540194
2021-02-13,1,13,14,10.281981378793716,0.7344272413424083
2021-02-14,1,15,16,9.169846957549453,0.5731154348468408
2021-02-15,4,8,12,5.762297315523028,0.48019144296025235
2021-02-16,2,5,7,3.350921206176281,0.4787030294537544
2021-02-17,3,5,8,4.836133636534214,0.6045167045667768
2021-02-18,1,9,10,7.636550188064575,0.7636550188064575
2021-02-19,5,2,7,2.0917375599965453,0.2988196514280779
2021-02-20,1,3,4,2.876449152827263,0.7191122882068157
2021-02-21,3,2,5,1.8795343907549977,0.37590687815099955
2021-02-22,2,6,8,5.548987706657499,0.6936234633321874
2021-02-23,2,4,6,3.247042319737375,0.5411737199562291
2021-02-24,3,1,4,1.3150458633899689,0.3287614658474922
2021-02-25,4,8,12,6.758668811060488,0.5632224009217074
2021-02-26,4,3,7,2.759721675887704,0.3942459536982434
2021-02-27,0,5,5,4.147786319255829,0.8295572638511658
2021-02-28,9,8,17,7.55860750656575,0.4446239709744559
2021-03-01,3,4,7,3.8323922995477915,0.547484614221113
2021-03-02,3,1,4,1.3087503407150507,0.3271875851787627
2021-03-03,0,1,1,0.8970111608505249,0.8970111608505249
2021-03-04,3,0,3,0.075465502217412,0.025155167405803997
2021-03-05,5,9,14,8.766780074685812,0.6261985767632723
2021-03-06,2,4,6,3.92925488576293,0.6548758142938217
2021-03-07,1,3,4,2.252363263629377,0.5630908159073442
2021-03-08,2,6,8,5.303570067510009,0.6629462584387511
2021-03-09,1,3,4,2.658568352460861,0.6646420881152153
2021-03-10,1,3,4,2.5312353102490306,0.6328088275622576
2021-03-11,0,0,0,0.0,0.5
2021-03-12,1,7,8,5.623119965195656,0.702889995649457
2021-03-13,1,0,1,0.07772088795900345,0.07772088795900345
2021-03-14,2,1,3,1.3037534840404987,0.43458449468016624
2021-03-15,3,0,3,0.4838353260420263,0.16127844201400876
2021-03-16,1,0,1,0.003927932120859623,0.003927932120859623
2021-03-17,1,5,6,4.227815829217434,0.704635971536239
2021-03-18,3,3,6,2.296354554593563,0.3827257590989272
2021-03-19,1,0,1,0.18732616305351257,0.18732616305351257
2021-03-20,3,4,7,3.5564413592219353,0.5080630513174194
2021-03-21,1,1,2,0.9917687214910984,0.4958843607455492
2021-03-22,2,5,7,4.238416410982609,0.6054880587118012
2021-03-23,2,5,7,4.479010684415698,0.6398586692022425
2021-03-24,1,6,7,5.198507120832801,0.7426438744046858
2021-03-25,4,2,6,2.252056217752397,0.37534270295873284
2021-03-26,1,2,3,1.7148553021252155,0.5716184340417385
2021-03-27,4,4,8,3.378165745642036,0.4222707182052545
2021-03-28,0,7,7,5.556783735752106,0.7938262479645866
2021-03-29,1,1,2,1.00398900359869,0.501994501799345
2021-03-30,0,1,1,0.8240941166877747,0.8240941166877747
2021-03-31,3,3,6,2.727984072640538,0.4546640121067564
2021-04-01,0,4,4,3.272481918334961,0.8181204795837402
2021-04-02,1,1,2,1.1794481426477432,0.5897240713238716
2021-04-03,2,4,6,3.5020167902112007,0.5836694650352001
2021-04-04,4,3,7,2.8032873133197427,0.40046961618853466
2021-04-05,3,8,11,6.183645077049732,0.5621495524590666
2021-04-06,0,6,6,4.304030179977417,0.7173383633295695
2021-04-07,4,5,9,5.4655632972717285,0.6072848108079698
2021-04-08,3,1,4,0.9805969512090087,0.24514923780225217
2021-04-09,4,6,10,5.093403469072655,0.5093403469072655
2021-04-10,4,9,13,6.882669052109122,0.529436080931471
2021-04-11,1,67,68,53.39088053628802,0.7851600078865886
2021-04-12,1,9,10,7.506869301199913,0.7506869301199913
2021-04-13,8,44,52,31.875465482473373,0.6129897208167956
2021-04-14,1,2,3,1.6188563145697117,0.5396187715232372
2021-04-15,1,2,3,1.6034937906078994,0.5344979302026331
2021-04-16,1,5,6,4.146015096921474,0.691002516153579
2021-04-17,0,3,3,2.343700110912323,0.7812333703041077
2021-04-18,1,1,2,0.7817888706922531,0.39089443534612656
2021-04-19,2,10,12,7.9494074285030365,0.6624506190419197
2021-04-20,1,3,4,2.518327604047954,0.6295819010119885
2021-04-21,2,4,6,3.7145772874355316,0.6190962145725886
2021-04-22,1,2,3,1.7258252389729023,0.5752750796576341
2021-04-23,3,18,21,16.052579006180167,0.7644085241038174
2021-04-24,3,3,6,3.036050021648407,0.5060083369414011
2021-04-25,0,2,2,1.6405105590820312,0.8202552795410156
2021-04-26,1,4,5,3.5981906317174435,0.7196381263434887
2021-04-27,1,28,29,24.67887943983078,0.8509958427527855
2021-04-28,2,4,6,3.581594865769148,0.5969324776281913
2021-04-29,2,5,7,4.670770511031151,0.6672529301473072
2021-04-30,2,4,6,4.036550804972649,0.6727584674954414
2021-05-01,3,3,6,2.560092670843005,0.42668211180716753
2021-05-02,3,1,4,1.9445605129003525,0.4861401282250881
2021-05-03,12,28,40,22.982127090450376,0.5745531772612594
2021-05-04,6,7,13,7.044626604765654,0.5418943542127426
2021-05-05,3,5,8,4.393082767724991,0.5491353459656239
2021-05-06,2,5,7,4.657068036496639,0.6652954337852341
2021-05-07,1,5,6,4.352242909371853,0.7253738182286421
2021-05-08,1,1,2,1.0604298114776611,0.5302149057388306
2021-05-09,0,3,3,2.2119961977005005,0.7373320659001669
2021-05-10,2,4,6,3.617745795752853,0.6029576326254755
2021-05-11,1,4,5,3.3150007650256157,0.6630001530051232
2021-05-12,3,2,5,2.010495367459953,0.4020990734919906
2021-05-13,1,3,4,1.9822123646736145,0.4955530911684036
2021-05-14,10,5,15,6.1939114117994905,0.41292742745329936
2021-05-15,3,2,5,2.024942319840193,0.40498846396803856
2021-05-16,2,3,5,2.9436056688427925,0.5887211337685585
2021-05-17,5,2,7,3.0221093893051147,0.43172991275787354
2021-05-18,12,3,15,6.525418221950531,0.43502788146336874
2021-05-19,2,3,5,2.2209828086197376,0.4441965617239475
2021-05-20,2,2,4,1.8177952468395233,0.45444881170988083
2021-05-21,0,2,2,1.5680731534957886,0.7840365767478943
2021-05-22,1,0,1,0.0771370381116867,0.0771370381116867
2021-05-23,4,1,5,1.8477340247482061,0.3695468049496412
2021-05-24,2,9,11,8.17213598638773,0.7429214533079754
2021-05-25,1,4,5,3.3232278674840927,0.6646455734968185
2021-05-26,2,0,2,0.19213934242725372,0.09606967121362686
2021-05-27,6,1,7,1.6492637461051345,0.2356091065864478
2021-05-28,1,1,2,0.6528887376189232,0.3264443688094616
2021-05-29,2,1,3,1.0700866654515266,0.3566955551505089
2021-05-30,2,2,4,1.9730111360549927,0.49325278401374817
2021-05-31,0,3,3,2.4338279962539673,0.8112759987513224
2021-06-01,0,1,1,0.8234812021255493,0.8234812021255493
2021-06-02,4,3,7,3.1187520367093384,0.4455360052441912
2021-06-03,3,6,9,5.393603730946779,0.599289303438531
2021-06-04,5,0,5,0.6668847799301147,0.13337695598602295
2021-06-05,2,2,4,1.819637455046177,0.4549093637615442
2021-06-06,4,1,5,1.0436537265777588,0.20873074531555175
2021-06-07,3,5,8,4.814729365054518,0.6018411706318147
2021-06-08,4,4,8,3.7020582538098097,0.4627572817262262
2021-06-09,3,7,10,6.475078918039799,0.6475078918039798
2021-06-10,2,2,4,1.781254113651812,0.445313528412953
2021-06-11,5,9,14,7.580580327659845,0.5414700234042746
2021-06-12,2,3,5,2.5979790575802326,0.5195958115160465
2021-06-13,1,2,3,2.198067843914032,0.7326892813046774
2021-06-14,2,4,6,3.671458438038826,0.6119097396731377
2021-06-15,2,0,2,0.12129266187548637,0.06064633093774319
2021-06-16,0,3,3,2.799604594707489,0.933201531569163
2021-06-17,1,4,5,3.2173258550465107,0.6434651710093021
2021-06-18,2,7,9,6.784768305718899,0.7538631450798776
2021-06-19,0,2,2,1.6948118805885315,0.8474059402942657
2021-06-20,2,1,3,0.7006952185183764,0.2335650728394588
2021-06-21,2,3,5,3.025264819152653,0.6050529638305306
2021-06-22,4,3,7,2.955861698836088,0.42226595697658403
2021-06-23,2,0,2,0.460811972618103,0.2304059863090515
2021-06-24,3,7,10,6.088144822046161,0.6088144822046161
2021-06-25,5,3,8,4.018307626247406,0.5022884532809258
2021-06-26,2,2,4,2.442707911133766,0.6106769777834415
2021-06-27,4,5,9,4.402571452781558,0.4891746058646176
2021-06-28,1,5,6,4.54685472138226,0.7578091202303767
2021-06-29,1,3,4,3.135191887617111,0.7837979719042778
2021-06-30,3,2,5,2.107292301952839,0.4214584603905678
2021-07-01,2,1,3,0.6315534599125385,0.21051781997084618
2021-07-02,1,0,1,0.0470951646566391,0.0470951646566391
2021-07-03,2,2,4,2.1708102226257324,0.5427025556564331
2021-07-04,0,3,3,2.510727345943451,0.8369091153144836
2021-07-05,3,7,10,5.706802593544126,0.5706802593544126
2021-07-06,0,2,2,1.533504843711853,0.7667524218559265
2021-07-07,0,0,0,0.0,0.5
2021-07-08,1,0,1,0.006535976193845272,0.006535976193845272
2021-07-09,4,5,9,4.29700283287093,0.47744475920788115
2021-07-10,3,1,4,1.0266075218096375,0.2566518804524094
2021-07-11,1,4,5,3.6093894243240356,0.7218778848648071
2021-07-12,2,1,3,0.7336281659081578,0.24454272196938595
2021-07-13,2,0,2,0.39838689286261797,0.19919344643130898
2021-07-14,2,4,6,3.8399802967906,0.6399967161317667
2021-07-15,3,0,3,0.5475263427942991,0.18250878093143305
2021-07-16,1,2,3,1.9624432176351547,0.6541477392117182
2021-07-17,1,0,1,0.45216885209083557,0.45216885209083557
2021-07-18,4,0,4,0.08022247441112995,0.020055618602782488
2021-07-19,1,1,2,1.0021424926817417,0.5010712463408709
2021-07-20,1,4,5,3.3743150178343058,0.6748630035668611
2021-07-21,0,1,1,0.5782784223556519,0.5782784223556519
2021-07-22,2,3,5,2.5760793769732118,0.5152158753946423
2021-07-23,0,14,14,10.778832912445068,0.7699166366032192
2021-07-24,3,1,4,0.9299862529151142,0.23249656322877854
2021-07-25,3,2,5,1.9167717890813947,0.3833543578162789
2021-07-26,3,1,4,0.7618331201374531,0.19045828003436327
2021-07-27,1,5,6,4.422734096646309,0.7371223494410515
2021-07-28,11,9,20,8.181734312791377,0.4090867156395689
2021-07-29,4,3,7,2.2925854129716754,0.3275122018530965
2021-07-30,12,6,18,7.293480311520398,0.4051933506400221
2021-07-31,13,11,24,10.488174088299274,0.43700725367913645
2021-08-01,105,35,140,47.24148178612813,0.33743915561520094
2021-08-02,29,11,40,13.271425467450172,0.33178563668625427
2021-08-03,11,14,25,11.512452686205506,0.46049810744822023
2021-08-04,23,14,37,13.744344040751457,0.3714687578581475
2021-08-05,13,7,20,6.597901283297688,0.3298950641648844
2021-08-06,11,12,23,10.345013580750674,0.4497831991630728
2021-08-07,5,9,14,8.51658732816577,0.608327666297555
2021-08-08,7,5,12,4.427759071346372,0.3689799226121977
2021-08-09,7,32,39,25.53287049359642,0.6546889870152928
2021-08-10,13,103,116,78.99820182146505,0.6810189812195262
2021-08-11,5,42,47,31.585236582905054,0.6720263102745756
2021-08-12,11,16,27,13.214338968507946,0.4894199617965906
2021-08-13,10,63,73,47.92000096850097,0.6564383694315201
2021-08-14,8,11,19,9.96474802494049,0.524460422365289
2021-08-15,8,10,18,8.727304773870856,0.48485026521504754
2021-08-16,4,15,19,11.368160190992057,0.5983242205785293
2021-08-17,179,68,247,101.57291687186807,0.41122638409663187
2021-08-18,22,49,71,39.40296233538538,0.5549713004983856
2021-08-19,8,6,14,4.700133001431823,0.33572378581655876
2021-08-20,35,3,38,6.497732441872358,0.17099295899664102
2021-08-21,18,11,29,10.84439575811848,0.37394468131443037
2021-08-22,6,7,13,5.404451586306095,0.4157270451004689
2021-08-23,6,7,13,6.274574818089604,0.48265960139150804
2021-08-24,10,5,15,4.6142657389864326,0.3076177159324288
2021-08-25,5,7,12,5.717840328812599,0.4764866940677166
2021-08-26,6,20,26,15.73214519303292,0.6050825074243431
2021-08-27,8,18,26,14.095977925695479,0.5421529971421338
2021-08-28,4,7,11,6.118031229823828,0.5561846572567116
2021-08-29,3,8,11,6.654138332232833,0.6049216665666212
2021-08-30,9,1,10,1.4424185836687684,0.14424185836687684
2021-08-31,5,2,7,1.7253114813938737,0.2464730687705534
2021-09-01,3,8,11,6.384881062433124,0.5804437329484657
2021-09-02,4,15,19,12.74805462360382,0.6709502433475695
2021-09-03,5,1,6,1.1652739415876567,0.1942123235979428
2021-09-04,6,1,7,1.7630867464467883,0.25186953520668404
2021-09-05,2,0,2,0.06853741453960538,0.03426870726980269
2021-09-06,2,2,4,1.8043385464698076,0.4510846366174519
2021-09-07,3,2,5,2.1886101462878287,0.43772202925756576
2021-09-08,3,1,4,0.5672861989587545,0.14182154973968863
2021-09-09,1,2,3,1.7947063520550728,0.5982354506850243
2021-09-10,2,3,5,2.4660265371203423,0.49320530742406843
2021-09-11,11,0,11,1.4495812309905887,0.13178011190823533
2021-09-12,4,2,6,2.6847510836087167,0.44745851393478614
2021-09-13,3,6,9,5.446261215955019,0.6051401351061132
2021-09-14,4,10,14,8.776836813660339,0.6269169152614528
2021-09-15,7,4,11,4.638450901955366,0.4216773547232151
2021-09-16,3,4,7,3.839045614004135,0.5484350877148765
2021-09-17,2,4,6,3.778765946626663,0.6297943244377772
2021-09-18,9,3,12,4.679808057844639,0.3899840048203866
2021-09-19,7,4,11,4.625832932069898,0.42053026655180886
2021-09-20,3,11,14,8.803178906440735,0.6287984933171954
2021-09-21,6,2,8,1.5414232248440385,0.1926779031055048
2021-09-22,4,2,6,2.3092384692281485,0.3848730782046914
2021-09-23,3,3,6,3.05710578430444,0.5095176307174066
2021-09-24,2,4,6,3.3769987570121884,0.5628331261686981
2021-09-25,2,4,6,3.7092787753790617,0.6182131292298436
2021-09-26,2,2,4,1.9041286334395409,0.4760321583598852
2021-09-27,12,60,72,46.03600482502952,0.6393889559031878
2021-09-28,7,8,15,8.75883112847805,0.58392207523187
2021-09-29,7,2,9,3.344572499394417,0.37161916659937966
2021-09-30,1,5,6,3.8194178640842438,0.6365696440140406
2021-10-01,1,3,4,2.599637944251299,0.6499094860628247
2021-10-02,3,12,15,9.506280707195401,0.6337520471463601
2021-10-03,4,7,11,5.670072071254253,0.5154610973867503
2021-10-04,2,9,11,6.6725414539687335,0.6065946776335213
2021-10-05,1,3,4,3.066277265548706,0.7665693163871765
2021-10-06,4,2,6,2.038802459836006,0.3398004099726677
2021-10-07,5,5,10,5.049963716417551,0.5049963716417551
2021-10-08,6,6,12,5.679278225172311,0.4732731854310259
2021-10-09,5,7,12,5.637653765734285,0.4698044804778571
2021-10-10,7,27,34,23.2327126134187,0.6833150768652558
2021-10-11,3,11,14,9.173952950630337,0.6552823536164526
2021-10-12,4,0,4,0.9695280166342854,0.24238200415857136
2021-10-13,5,1,6,2.538478448521346,0.4230797414202243
2021-10-14,5,9,14,7.745893576182425,0.5532781125844589
2021-10-15,3,4,7,3.599684634245932,0.5142406620351332
2021-10-16,4,6,10,5.2499493872746825,0.5249949387274683
2021-10-17,5,2,7,2.6005138806067407,0.3715019829438201
2021-10-18,4,1,5,0.9392909915186465,0.1878581983037293
2021-10-19,3,7,10,7.117610856890678,0.7117610856890678
2021-10-20,1,5,6,4.110567972064018,0.6850946620106697
2021-10-21,4,1,5,0.9737019147723913,0.19474038295447826
2021-10-22,1,7,8,5.535415114834905,0.6919268893543631
2021-10-23,2,6,8,5.292309081181884,0.6615386351477355
2021-10-24,3,2,5,1.97225621342659,0.394451242685318
2021-10-25,4,12,16,9.43136784946546,0.5894604905915912
2021-10-26,2,14,16,11.169724874198437,0.6981078046374023
2021-10-27,3,7,10,6.003104815259576,0.6003104815259576
2021-10-28,1,5,6,4.734618604183197,0.7891031006971995
2021-10-29,0,10,10,8.349639058113098,0.8349639058113099
2021-10-30,4,3,7,3.151950000785291,0.4502785715407559
2021-10-31,6,2,8,2.098988543730229,0.26237356796627864
2021-11-01,4,4,8,3.8640869832597673,0.4830108729074709
2021-11-02,4,3,7,3.6491442187689245,0.5213063169669893
2021-11-03,2,5,7,5.13842585682869,0.7340608366898128
2021-11-04,1,5,6,4.270173843950033,0.7116956406583389
2021-11-05,3,5,8,4.594414856284857,0.5743018570356071
2021-11-06,3,3,6,2.8037842754274607,0.4672973792379101
2021-11-07,1,6,7,5.096663609147072,0.7280948013067245
2021-11-08,2,2,4,2.0006250701844692,0.5001562675461173
2021-11-09,3,1,4,1.1606041137129068,0.2901510284282267
2021-11-10,3,1,4,0.8862845031544566,0.22157112578861415
2021-11-11,2,1,3,0.7489038780331612,0.2496346260110537
2021-11-12,3,3,6,2.8698893152177334,0.47831488586962223
2021-11-13,5,5,10,4.293915461748838,0.42939154617488384
2021-11-14,4,4,8,3.1765964468941092,0.39707455586176366
2021-11-15,3,1,4,1.6064059883356094,0.40160149708390236
2021-11-16,2,7,9,5.810791558586061,0.6456435065095624
2021-11-17,5,6,11,6.064395613502711,0.55130869213661
2021-11-18,2,5,7,4.500933056697249,0.6429904366710356
2021-11-19,5,4,9,3.9988900425378233,0.4443211158375359
2021-11-20,4,4,8,3.646172128384933,0.4557715160481166
2021-11-21,4,4,8,4.0421072617173195,0.5052634077146649
2021-11-22,1,0,1,0.0050436025485396385,0.0050436025485396385
2021-11-23,1,1,2,0.9911133646965027,0.49555668234825134
2021-11-24,5,3,8,2.820966001600027,0.3526207502000034
2021-11-25,6,6,12,5.427043377887458,0.4522536148239548
2021-11-26,12,7,19,7.323965577408671,0.3854718724951932
2021-11-27,7,2,9,2.17720929114148,0.24191214346016446
2021-11-28,5,5,10,4.8382288767024875,0.4838228876702487
2021-11-29,6,3,9,3.2375459233298898,0.3597273248144322
2021-11-30,5,3,8,3.226734708994627,0.4033418386243284
2021-12-01,4,3,7,2.819270797073841,0.40275297101054874
2021-12-02,4,3,7,2.6441451765131205,0.3777350252161601
2021-12-03,1,5,6,4.545827258378267,0.7576378763963779
2021-12-04,1,2,3,1.4316829023882747,0.47722763412942487
2021-12-05,3,1,4,1.0811850260943174,0.27029625652357936
2021-12-06,3,2,5,1.6607037894427776,0.3321407578885555
2021-12-07,3,2,5,2.0990025885403156,0.41980051770806315
2021-12-08,7,8,15,8.519625655375421,0.5679750436916947
2021-12-09,4,3,7,3.1209873096086085,0.44585532994408694
2021-12-10,7,6,13,4.9789512706920505,0.3829962515916962
2021-12-11,5,3,8,3.313144411891699,0.41414305148646235
2021-12-12,1,3,4,2.4441166073083878,0.6110291518270969
2021-12-13,2,4,6,3.26725123077631,0.5445418717960516
2021-12-14,3,5,8,4.316696286201477,0.5395870357751846
2021-12-15,1,12,13,10.211888523772359,0.7855298864440277
2021-12-16,4,4,8,4.035141324624419,0.5043926655780524
2021-12-17,2,4,6,3.4042642491403967,0.5673773748567328
2021-12-18,3,0,3,0.21212982013821602,0.070709940046072
2021-12-19,5,2,7,2.0093197906389832,0.2870456843769976
2021-12-20,2,2,4,1.787082965951413,0.44677074148785323
2021-12-21,5,4,9,3.529110678471625,0.3921234087190694
2021-12-22,4,2,6,2.0238104052841663,0.3373017342140277
2021-12-23,3,5,8,5.093021020293236,0.6366276275366545
2021-12-24,3,2,5,2.6830418184399605,0.5366083636879921
2021-12-25,0,3,3,2.3897939920425415,0.7965979973475138
2021-12-26,2,5,7,4.634840273298323,0.6621200390426176
2021-12-27,1,2,3,1.790578993037343,0.596859664345781
2021-12-28,0,1,1,0.9373295307159424,0.9373295307159424
2021-12-29,1,3,4,2.4870824459940195,0.6217706114985049
2021-12-30,10,105,115,92.40294300764799,0.8035038522404173
2021-12-31,5,14,19,12.963079676032066,0.6822673513701087
