,negative_sum,positive_sum,total_sum,sentiment_score,average_score
2020-02-01,0,0,0,0.0,0.5
2020-02-02,0,0,0,0.0,0.5
2020-02-03,0,0,0,0.0,0.5
2020-02-04,0,0,0,0.0,0.5
2020-02-05,0,0,0,0.0,0.5
2020-02-06,0,0,0,0.0,0.5
2020-02-07,0,0,0,0.0,0.5
2020-02-08,0,0,0,0.0,0.5
2020-02-09,0,0,0,0.0,0.5
2020-02-10,0,0,0,0.0,0.5
2020-02-11,0,0,0,0.0,0.5
2020-02-12,0,0,0,0.0,0.5
2020-02-13,0,0,0,0.0,0.5
2020-02-14,0,0,0,0.0,0.5
2020-02-15,1,0,1,0.11240862309932709,0.11240862309932709
2020-02-16,0,0,0,0.0,0.5
2020-02-17,0,0,0,0.0,0.5
2020-02-18,0,7,7,5.537746787071228,0.7911066838673183
2020-02-19,2,20,22,15.838069215416908,0.7199122370644049
2020-02-20,2,9,11,7.5651072561740875,0.6877370232885535
2020-02-21,3,11,14,10.102494925260544,0.7216067803757531
2020-02-22,34,9,43,22.548494040966034,0.5243835823480473
2020-02-23,3,2,5,2.900389812886715,0.580077962577343
2020-02-24,3,4,7,4.813579171895981,0.6876541674137115
2020-02-25,40,48,88,40.038714760914445,0.4549853950103914
2020-02-26,30,52,82,46.003118528053164,0.5610136405860142
2020-02-27,24,65,89,54.88884377013892,0.6167285816869541
2020-02-28,24,30,54,27.249874842818826,0.5046273119040523
2020-02-29,22,25,47,23.665997658390552,0.5035318650721394
2020-03-01,47,62,109,55.729081666329876,0.5112759785901824
2020-03-02,73,124,197,103.09418863384053,0.5233207544865002
2020-03-03,62,88,150,82.4702070299536,0.5498013801996907
2020-03-04,65,45,110,40.49550442118198,0.3681409492834725
2020-03-05,61,32,93,32.43678244808689,0.3487826069686762
2020-03-06,69,31,100,31.74738269415684,0.3174738269415684
2020-03-07,115,23,138,30.079115611501038,0.2179646058804423
2020-03-08,34,28,62,25.345765871927142,0.4088026753536636
2020-03-09,40,27,67,26.97074396861717,0.40254841744204733
2020-03-10,30,13,43,13.056377626024187,0.30363668897730667
2020-03-11,52,19,71,19.620846649631858,0.2763499528117163
2020-03-12,50,21,71,20.59331051283516,0.29004662694134026
2020-03-13,47,40,87,35.91493664262816,0.4128153637083697
2020-03-14,81,29,110,32.85152906598523,0.29865026423622937
2020-03-15,50,23,73,23.08952968707308,0.3162949272201792
2020-03-16,44,19,63,18.292894893325865,0.2903634110051725
2020-03-17,63,19,82,18.89302142430097,0.23040270029635326
2020-03-18,85,28,113,30.081410160288215,0.2662071695600727
2020-03-19,35,18,53,16.847728613764048,0.3178816719578122
2020-03-20,49,21,70,19.662064601667225,0.28088663716667467
2020-03-21,49,14,63,15.409268822986633,0.24459156861883544
2020-03-22,43,22,65,25.545381978619844,0.3930058765941514
2020-03-23,10,15,25,12.96974660642445,0.518789864256978
2020-03-24,21,15,36,14.267974501475692,0.3963326250409914
2020-03-25,11,29,40,25.8265990014188,0.6456649750354699
2020-03-26,2,34,36,26.96903091808781,0.7491397477246614
2020-03-27,6,7,13,6.423686467111111,0.4941297282393162
2020-03-28,9,5,14,5.869010789319873,0.4192150563799909
2020-03-29,3,5,8,4.69394788891077,0.5867434861138463
2020-03-30,4,5,9,4.688975431025028,0.5209972701138921
2020-03-31,7,8,15,7.2707611452788115,0.4847174096852541
2020-04-01,2,15,17,12.597444484941661,0.7410261461730389
2020-04-02,3,9,12,7.972643695771694,0.6643869746476412
2020-04-03,10,3,13,4.454526014626026,0.34265584727892506
2020-04-04,5,2,7,2.337297733873129,0.3338996762675898
2020-04-05,1,5,6,4.748399794101715,0.7913999656836191
2020-04-06,2,3,5,2.3624871484935284,0.4724974296987057
2020-04-07,9,3,12,2.661609508097172,0.221800792341431
2020-04-08,10,2,12,2.628290745895356,0.219024228824613
2020-04-09,3,7,10,6.237234458327293,0.6237234458327293
2020-04-10,4,2,6,1.8797637782990932,0.31329396304984886
2020-04-11,5,16,21,12.54444888792932,0.5973547089490152
2020-04-12,3,29,32,22.187697120010853,0.6933655350003392
2020-04-13,0,6,6,4.706106662750244,0.784351110458374
2020-04-14,4,2,6,2.188186085317284,0.36469768088621396
2020-04-15,5,3,8,3.767048643901944,0.470881080487743
2020-04-16,3,5,8,4.194880328141153,0.5243600410176441
2020-04-17,2,3,5,2.72574741858989,0.545149483717978
2020-04-18,5,2,7,1.8463967605493963,0.2637709657927709
2020-04-19,9,3,12,3.193829394876957,0.26615244957307976
2020-04-20,2,3,5,2.5370496378745884,0.5074099275749177
2020-04-21,3,0,3,0.5432055070996284,0.18106850236654282
2020-04-22,6,4,10,4.593273155391216,0.45932731553912165
2020-04-23,3,3,6,2.813196048140526,0.468866008023421
2020-04-24,1,1,2,0.5611040182411671,0.28055200912058353
2020-04-25,2,3,5,2.734003484249115,0.546800696849823
2020-04-26,1,2,3,1.7271913178265095,0.5757304392755032
2020-04-27,4,3,7,2.998737722635269,0.4283911032336099
2020-04-28,6,1,7,1.6589454989880323,0.2369922141411475
2020-04-29,5,14,19,12.573452398180962,0.66176065253584
2020-04-30,3,17,20,14.43526104092598,0.721763052046299
2020-05-01,2,13,15,10.388766489923,0.6925844326615334
2020-05-02,4,3,7,3.0733287488110363,0.43904696411586236
2020-05-03,21,0,21,1.3129860232584178,0.06252314396468657
2020-05-04,1,4,5,4.20949512720108,0.8418990254402161
2020-05-05,1,0,1,0.17934374511241913,0.17934374511241913
2020-05-06,0,1,1,0.9528170228004456,0.9528170228004456
2020-05-07,0,0,0,0.0,0.5
2020-05-08,1,1,2,0.6949854493141174,0.3474927246570587
2020-05-09,0,3,3,2.5874743461608887,0.8624914487202963
2020-05-10,2,0,2,0.288288040086627,0.1441440200433135
2020-05-11,1,2,3,1.8892165953293443,0.6297388651097814
2020-05-12,1,0,1,0.060147661715745926,0.060147661715745926
2020-05-13,1,0,1,0.035034384578466415,0.035034384578466415
2020-05-14,2,0,2,0.0640622042119503,0.03203110210597515
2020-05-15,3,3,6,2.619897802360356,0.436649633726726
2020-05-16,0,3,3,2.6089616417884827,0.8696538805961609
2020-05-17,1,2,3,1.6476211845874786,0.5492070615291595
2020-05-18,0,0,0,0.0,0.5
2020-05-19,1,1,2,0.795766606926918,0.397883303463459
2020-05-20,1,2,3,1.5992009490728378,0.5330669830242792
2020-05-21,0,0,0,0.0,0.5
2020-05-22,1,1,2,0.5992877185344696,0.2996438592672348
2020-05-23,1,3,4,2.43033854290843,0.6075846357271075
2020-05-24,0,1,1,0.8764237761497498,0.8764237761497498
2020-05-25,0,3,3,1.5421253442764282,0.5140417814254761
2020-05-26,1,2,3,2.0392285883426666,0.6797428627808889
2020-05-27,2,2,4,2.068242624402046,0.5170606561005116
2020-05-28,4,0,4,0.1346985176205635,0.03367462940514088
2020-05-29,0,1,1,0.8565126061439514,0.8565126061439514
2020-05-30,0,2,2,1.4242948293685913,0.7121474146842957
2020-05-31,1,1,2,1.0331642404198647,0.5165821202099323
2020-06-01,1,1,2,0.867089616600424,0.433544808300212
2020-06-02,2,0,2,0.1683288961648941,0.08416444808244705
2020-06-03,3,3,6,2.619011646602303,0.4365019411003838
2020-06-04,1,0,1,0.023155577480793,0.023155577480793
2020-06-05,2,1,3,0.9126992085948586,0.30423306953161955
2020-06-06,0,0,0,0.0,0.5
2020-06-07,0,2,2,1.9282758831977844,0.9641379415988922
2020-06-08,1,1,2,0.9881521314382553,0.49407606571912766
2020-06-09,0,0,0,0.0,0.5
2020-06-10,0,2,2,1.2803704142570496,0.6401852071285248
2020-06-11,1,2,3,1.8144336342811584,0.6048112114270529
2020-06-12,2,1,3,1.2684576325118542,0.42281921083728474
2020-06-13,1,0,1,0.014911504462361336,0.014911504462361336
2020-06-14,2,0,2,0.04707141499966383,0.023535707499831915
2020-06-15,0,1,1,0.6754423975944519,0.6754423975944519
2020-06-16,0,0,0,0.0,0.5
2020-06-17,0,1,1,0.5198760628700256,0.5198760628700256
2020-06-18,4,1,5,1.5723995044827461,0.3144799008965492
2020-06-19,1,1,2,0.7367218704894185,0.36836093524470925
2020-06-20,3,0,3,0.07342359656468034,0.024474532188226778
2020-06-21,2,2,4,1.541688953526318,0.3854222383815795
2020-06-22,3,0,3,0.0743271941319108,0.0247757313773036
2020-06-23,2,2,4,1.9508563922718167,0.4877140980679542
2020-06-24,2,1,3,1.0042479187250137,0.33474930624167126
2020-06-25,2,1,3,1.0830262396484613,0.3610087465494871
2020-06-26,1,0,1,0.005294798407703638,0.005294798407703638
2020-06-27,0,2,2,1.9576128125190735,0.9788064062595367
2020-06-28,1,0,1,0.027076687663793564,0.027076687663793564
2020-06-29,0,0,0,0.0,0.5
2020-06-30,0,1,1,0.9522956013679504,0.9522956013679504
2020-07-01,3,1,4,1.2948813810944557,0.32372034527361393
2020-07-02,3,1,4,1.3335740026086569,0.3333935006521642
2020-07-03,2,2,4,1.865372572094202,0.4663431430235505
2020-07-04,0,5,5,4.3603270053863525,0.8720654010772705
2020-07-05,3,1,4,1.326852647587657,0.33171316189691424
2020-07-06,2,2,4,2.2927000895142555,0.5731750223785639
2020-07-07,1,1,2,1.209336370229721,0.6046681851148605
2020-07-08,0,1,1,0.9720805287361145,0.9720805287361145
2020-07-09,2,1,3,1.0451266840100288,0.3483755613366763
2020-07-10,1,0,1,0.35284098982810974,0.35284098982810974
2020-07-11,0,2,2,1.8868495225906372,0.9434247612953186
2020-07-12,1,1,2,1.100562423467636,0.550281211733818
2020-07-13,6,3,9,3.167366486042738,0.3519296095603042
2020-07-14,0,1,1,0.9049054980278015,0.9049054980278015
2020-07-15,1,0,1,0.19081825017929077,0.19081825017929077
2020-07-16,1,0,1,0.13115787506103516,0.13115787506103516
2020-07-17,0,1,1,0.9692533016204834,0.9692533016204834
2020-07-18,2,1,3,1.1718407422304153,0.3906135807434718
2020-07-19,0,0,0,0.0,0.5
2020-07-20,0,0,0,0.0,0.5
2020-07-21,2,8,10,6.8647869527339935,0.6864786952733993
2020-07-22,9,2,11,3.2210301347076893,0.29282092133706267
2020-07-23,2,1,3,1.3765044212341309,0.45883480707804364
2020-07-24,1,1,2,0.9229531586170197,0.4614765793085098
2020-07-25,3,2,5,2.4255976462736726,0.4851195292547345
2020-07-26,0,0,0,0.0,0.5
2020-07-27,0,1,1,0.8676162958145142,0.8676162958145142
2020-07-28,2,3,5,2.6795139759778976,0.5359027951955795
2020-07-29,1,0,1,0.3871205151081085,0.3871205151081085
2020-07-30,3,0,3,0.7130484692752361,0.23768282309174538
2020-07-31,0,1,1,0.9711474180221558,0.9711474180221558
2020-08-01,0,2,2,1.7849430441856384,0.8924715220928192
2020-08-02,0,1,1,0.6564193964004517,0.6564193964004517
2020-08-03,0,0,0,0.0,0.5
2020-08-04,1,0,1,0.010787456296384335,0.010787456296384335
2020-08-05,0,0,0,0.0,0.5
2020-08-06,2,1,3,0.9851364940404892,0.3283788313468297
2020-08-07,2,0,2,0.43244682997465134,0.21622341498732567
2020-08-08,2,7,9,6.1347491927444935,0.6816387991938326
2020-08-09,1,0,1,0.4131592810153961,0.4131592810153961
2020-08-10,2,1,3,1.0006093010306358,0.33353643367687863
2020-08-11,2,0,2,0.21655234694480896,0.10827617347240448
2020-08-12,1,1,2,0.9947486892342567,0.49737434461712837
2020-08-13,2,1,3,0.7155666872859001,0.23852222909530005
2020-08-14,1,2,3,2.0685234665870667,0.6895078221956888
2020-08-15,2,0,2,0.20512707717716694,0.10256353858858347
2020-08-16,1,1,2,0.887389674782753,0.4436948373913765
2020-08-17,4,5,9,5.422614000737667,0.6025126667486297
2020-08-18,1,3,4,2.9264176711440086,0.7316044177860022
2020-08-19,9,0,9,0.8494914807379246,0.09438794230421384
2020-08-20,1,3,4,2.694656379520893,0.6736640948802233
2020-08-21,0,5,5,4.50334358215332,0.900668716430664
2020-08-22,1,1,2,0.9069828130304813,0.45349140651524067
2020-08-23,0,1,1,0.7521577477455139,0.7521577477455139
2020-08-24,1,4,5,3.5470404028892517,0.7094080805778503
2020-08-25,1,3,4,2.85718896985054,0.714297242462635
2020-08-26,1,1,2,0.8506691604852676,0.4253345802426338
2020-08-27,0,2,2,1.1185727715492249,0.5592863857746124
2020-08-28,0,2,2,1.5488767623901367,0.7744383811950684
2020-08-29,2,1,3,1.0145096126943827,0.33816987089812756
2020-08-30,2,2,4,1.8744410052895546,0.46861025132238865
2020-08-31,1,1,2,1.0372300148010254,0.5186150074005127
2020-09-01,1,1,2,0.8465441167354584,0.4232720583677292
2020-09-02,0,2,2,1.6550706028938293,0.8275353014469147
2020-09-03,0,1,1,0.922671914100647,0.922671914100647
2020-09-04,0,0,0,0.0,0.5
2020-09-05,1,4,5,3.9193580746650696,0.7838716149330139
2020-09-06,2,0,2,0.0943295918405056,0.0471647959202528
2020-09-07,0,1,1,0.8471565842628479,0.8471565842628479
2020-09-08,1,0,1,0.06811205297708511,0.06811205297708511
2020-09-09,1,0,1,0.04597191512584686,0.04597191512584686
2020-09-10,0,0,0,0.0,0.5
2020-09-11,0,0,0,0.0,0.5
2020-09-12,0,1,1,0.6536455154418945,0.6536455154418945
2020-09-13,1,0,1,0.28320178389549255,0.28320178389549255
2020-09-14,1,0,1,0.0898120254278183,0.0898120254278183
2020-09-15,0,1,1,0.9630872011184692,0.9630872011184692
2020-09-16,0,2,2,1.7343021035194397,0.8671510517597198
2020-09-17,3,2,5,2.3709482718259096,0.4741896543651819
2020-09-18,0,2,2,1.4491325616836548,0.7245662808418274
2020-09-19,1,2,3,1.838679887354374,0.6128932957847913
2020-09-20,2,0,2,0.4780773431994021,0.23903867159970105
2020-09-21,2,1,3,1.2004970386624336,0.40016567955414456
2020-09-22,0,1,1,0.9651211500167847,0.9651211500167847
2020-09-23,0,1,1,0.6867292523384094,0.6867292523384094
2020-09-24,0,1,1,0.9145978093147278,0.9145978093147278
2020-09-25,0,0,0,0.0,0.5
2020-09-26,0,1,1,0.8238710165023804,0.8238710165023804
2020-09-27,0,1,1,0.9747143387794495,0.9747143387794495
2020-09-28,0,2,2,1.874552845954895,0.9372764229774475
2020-09-29,0,1,1,0.8916170597076416,0.8916170597076416
2020-09-30,1,18,19,14.593484684824944,0.7680781413065759
2020-10-01,1,1,2,0.9292008671909571,0.46460043359547853
2020-10-02,0,0,0,0.0,0.5
2020-10-03,0,3,3,2.145644247531891,0.715214749177297
2020-10-04,0,0,0,0.0,0.5
2020-10-05,1,0,1,0.0057197692804038525,0.0057197692804038525
2020-10-06,1,0,1,0.01486531738191843,0.01486531738191843
2020-10-07,0,1,1,0.9218806624412537,0.9218806624412537
2020-10-08,0,0,0,0.0,0.5
2020-10-09,1,0,1,0.014687221497297287,0.014687221497297287
2020-10-10,0,0,0,0.0,0.5
2020-10-11,1,0,1,0.028095053508877754,0.028095053508877754
2020-10-12,0,0,0,0.0,0.5
2020-10-13,0,1,1,0.9870443940162659,0.9870443940162659
2020-10-14,1,2,3,2.021927386522293,0.673975795507431
2020-10-15,0,0,0,0.0,0.5
2020-10-16,1,0,1,0.3102678060531616,0.3102678060531616
2020-10-17,0,1,1,0.7879897356033325,0.7879897356033325
2020-10-18,1,0,1,0.10930432379245758,0.10930432379245758
2020-10-19,0,2,2,1.950894057750702,0.975447028875351
2020-10-20,0,1,1,0.809613823890686,0.809613823890686
2020-10-21,0,0,0,0.0,0.5
2020-10-22,0,0,0,0.0,0.5
2020-10-23,0,1,1,0.9754312038421631,0.9754312038421631
2020-10-24,1,0,1,0.02065919153392315,0.02065919153392315
2020-10-25,0,0,0,0.0,0.5
2020-10-26,1,0,1,0.013590137474238873,0.013590137474238873
2020-10-27,0,1,1,0.9563433527946472,0.9563433527946472
2020-10-28,0,0,0,0.0,0.5
2020-10-29,0,0,0,0.0,0.5
2020-10-30,3,0,3,0.6120313704013824,0.20401045680046082
2020-10-31,3,0,3,0.5189569294452667,0.17298564314842224
2020-11-01,0,0,0,0.0,0.5
2020-11-02,1,0,1,0.040921591222286224,0.040921591222286224
2020-11-03,0,0,0,0.0,0.5
2020-11-04,0,1,1,0.9366002678871155,0.9366002678871155
2020-11-05,2,0,2,0.1762853041291237,0.08814265206456184
2020-11-06,0,0,0,0.0,0.5
2020-11-07,0,2,2,1.947304368019104,0.973652184009552
2020-11-08,0,1,1,0.9169310331344604,0.9169310331344604
2020-11-09,0,0,0,0.0,0.5
2020-11-10,0,0,0,0.0,0.5
2020-11-11,1,0,1,0.22234438359737396,0.22234438359737396
2020-11-12,1,0,1,0.17296011745929718,0.17296011745929718
2020-11-13,0,1,1,0.9226154685020447,0.9226154685020447
2020-11-14,1,2,3,2.03264582157135,0.6775486071904501
2020-11-15,1,0,1,0.3993898928165436,0.3993898928165436
2020-11-16,0,0,0,0.0,0.5
2020-11-17,2,1,3,1.4929526299238205,0.4976508766412735
2020-11-18,0,1,1,0.852799654006958,0.852799654006958
2020-11-19,0,0,0,0.0,0.5
2020-11-20,0,0,0,0.0,0.5
2020-11-21,0,2,2,1.8750994801521301,0.9375497400760651
2020-11-22,0,0,0,0.0,0.5
2020-11-23,0,0,0,0.0,0.5
2020-11-24,0,0,0,0.0,0.5
2020-11-25,1,0,1,0.13552330434322357,0.13552330434322357
2020-11-26,0,0,0,0.0,0.5
2020-11-27,0,1,1,0.93043452501297,0.93043452501297
2020-11-28,2,0,2,0.2952256929129362,0.1476128464564681
2020-11-29,0,1,1,0.9376587867736816,0.9376587867736816
2020-11-30,0,2,2,1.8943655490875244,0.9471827745437622
2020-12-01,0,1,1,0.9395125508308411,0.9395125508308411
2020-12-02,0,0,0,0.0,0.5
2020-12-03,0,0,0,0.0,0.5
2020-12-04,0,1,1,0.9156351685523987,0.9156351685523987
2020-12-05,0,0,0,0.0,0.5
2020-12-06,1,1,2,0.7710910364985466,0.3855455182492733
2020-12-07,1,0,1,0.022925350815057755,0.022925350815057755
2020-12-08,0,0,0,0.0,0.5
2020-12-09,0,0,0,0.0,0.5
2020-12-10,1,0,1,0.025329789146780968,0.025329789146780968
2020-12-11,0,1,1,0.8728392720222473,0.8728392720222473
2020-12-12,0,1,1,0.5742383599281311,0.5742383599281311
2020-12-13,1,0,1,0.21040254831314087,0.21040254831314087
2020-12-14,0,0,0,0.0,0.5
2020-12-15,0,0,0,0.0,0.5
2020-12-16,0,0,0,0.0,0.5
2020-12-17,1,1,2,0.953166919760406,0.476583459880203
2020-12-18,2,0,2,0.011362116783857346,0.005681058391928673
2020-12-19,0,0,0,0.0,0.5
2020-12-20,0,0,0,0.0,0.5
2020-12-21,1,0,1,0.05972651019692421,0.05972651019692421
2020-12-22,0,0,0,0.0,0.5
2020-12-23,6,0,6,0.9429028574377298,0.15715047623962164
2020-12-24,0,0,0,0.0,0.5
2020-12-25,1,1,2,1.4225371479988098,0.7112685739994049
2020-12-26,1,0,1,0.03250761330127716,0.03250761330127716
2020-12-27,3,0,3,0.17786233313381672,0.059287444377938904
2020-12-28,1,0,1,0.10824166238307953,0.10824166238307953
2020-12-29,1,2,3,1.9764698147773743,0.6588232715924581
2020-12-30,4,0,4,0.7509066835045815,0.18772667087614536
2020-12-31,1,2,3,1.8180765844881535,0.6060255281627178
2021-01-01,0,2,2,1.7385478615760803,0.8692739307880402
2021-01-02,2,0,2,0.04953834507614374,0.02476917253807187
2021-01-03,0,2,2,1.5233252048492432,0.7616626024246216
2021-01-04,2,0,2,0.0335239889100194,0.0167619944550097
2021-01-05,6,2,8,2.339034072123468,0.2923792590154335
2021-01-06,2,0,2,0.05440398305654526,0.02720199152827263
2021-01-07,0,1,1,0.714505672454834,0.714505672454834
2021-01-08,2,1,3,1.0928543717600405,0.3642847905866802
2021-01-09,1,2,3,1.6055929567664862,0.5351976522554954
2021-01-10,0,3,3,2.324047565460205,0.7746825218200684
2021-01-11,2,0,2,0.04178798571228981,0.020893992856144905
2021-01-12,0,2,2,1.7690389156341553,0.8845194578170776
2021-01-13,2,1,3,1.1380592677742243,0.37935308925807476
2021-01-14,0,3,3,2.4876787066459656,0.8292262355486552
2021-01-15,3,1,4,1.4000766202807426,0.35001915507018566
2021-01-16,22,0,22,1.638586622197181,0.07448121009987187
2021-01-17,0,2,2,1.9107986688613892,0.9553993344306946
2021-01-18,0,3,3,2.038749873638153,0.6795832912127177
2021-01-19,0,0,0,0.0,0.5
2021-01-20,4,1,5,1.2139651142060757,0.24279302284121512
2021-01-21,1,0,1,0.32801470160484314,0.32801470160484314
2021-01-22,1,0,1,0.06651750952005386,0.06651750952005386
2021-01-23,0,0,0,0.0,0.5
2021-01-24,0,2,2,1.7486660480499268,0.8743330240249634
2021-01-25,0,0,0,0.0,0.5
2021-01-26,1,1,2,0.6982112601399422,0.3491056300699711
2021-01-27,0,2,2,1.6616114974021912,0.8308057487010956
2021-01-28,1,1,2,0.9900864474475384,0.4950432237237692
2021-01-29,2,0,2,0.11748679913580418,0.05874339956790209
2021-01-30,1,1,2,0.7450969368219376,0.3725484684109688
2021-01-31,1,1,2,1.0572214275598526,0.5286107137799263
2021-02-01,0,1,1,0.9009316563606262,0.9009316563606262
2021-02-02,0,1,1,0.5286436080932617,0.5286436080932617
2021-02-03,0,0,0,0.0,0.5
2021-02-04,1,0,1,0.04185052216053009,0.04185052216053009
2021-02-05,2,10,12,7.963572666049004,0.6636310555040836
2021-02-06,0,0,0,0.0,0.5
2021-02-07,0,1,1,0.6125457882881165,0.6125457882881165
2021-02-08,0,2,2,1.6116097569465637,0.8058048784732819
2021-02-09,0,2,2,1.6429458260536194,0.8214729130268097
2021-02-10,0,0,0,0.0,0.5
2021-02-11,0,0,0,0.0,0.5
2021-02-12,0,0,0,0.0,0.5
2021-02-13,0,0,0,0.0,0.5
2021-02-14,0,0,0,0.0,0.5
2021-02-15,0,1,1,0.8872271180152893,0.8872271180152893
2021-02-16,1,1,2,0.8999458448961377,0.44997292244806886
2021-02-17,1,0,1,0.016866596415638924,0.016866596415638924
2021-02-18,0,0,0,0.0,0.5
2021-02-19,1,2,3,1.9392672069370747,0.6464224023123583
2021-02-20,0,0,0,0.0,0.5
2021-02-21,0,0,0,0.0,0.5
2021-02-22,0,0,0,0.0,0.5
2021-02-23,0,0,0,0.0,0.5
2021-02-24,0,0,0,0.0,0.5
2021-02-25,0,1,1,0.8706880211830139,0.8706880211830139
2021-02-26,1,1,2,1.0689789950847626,0.5344894975423813
2021-02-27,0,0,0,0.0,0.5
2021-02-28,0,0,0,0.0,0.5
2021-03-01,0,0,0,0.0,0.5
2021-03-02,0,0,0,0.0,0.5
2021-03-03,0,1,1,0.5030571222305298,0.5030571222305298
2021-03-04,0,0,0,0.0,0.5
2021-03-05,0,2,2,1.699190616607666,0.849595308303833
2021-03-06,1,0,1,0.0042022522538900375,0.0042022522538900375
2021-03-07,0,0,0,0.0,0.5
2021-03-08,0,0,0,0.0,0.5
2021-03-09,0,0,0,0.0,0.5
2021-03-10,0,0,0,0.0,0.5
2021-03-11,1,1,2,0.7082423213869333,0.35412116069346666
2021-03-12,0,0,0,0.0,0.5
2021-03-13,0,0,0,0.0,0.5
2021-03-14,0,0,0,0.0,0.5
2021-03-15,0,0,0,0.0,0.5
2021-03-16,0,0,0,0.0,0.5
2021-03-17,0,1,1,0.9479753971099854,0.9479753971099854
2021-03-18,0,0,0,0.0,0.5
2021-03-19,0,1,1,0.9764451384544373,0.9764451384544373
2021-03-20,0,1,1,0.9748744964599609,0.9748744964599609
2021-03-21,0,1,1,0.7099695205688477,0.7099695205688477
2021-03-22,0,1,1,0.8132199048995972,0.8132199048995972
2021-03-23,0,0,0,0.0,0.5
2021-03-24,1,1,2,0.7764773778617382,0.3882386889308691
2021-03-25,1,0,1,0.01557936891913414,0.01557936891913414
2021-03-26,0,0,0,0.0,0.5
2021-03-27,0,1,1,0.649314820766449,0.649314820766449
2021-03-28,1,1,2,0.6452323491685092,0.3226161745842546
2021-03-29,0,0,0,0.0,0.5
2021-03-30,0,0,0,0.0,0.5
2021-03-31,0,50,50,47.320907056331635,0.9464181411266327
2021-04-01,0,0,0,0.0,0.5
2021-04-02,0,0,0,0.0,0.5
2021-04-03,0,0,0,0.0,0.5
2021-04-04,0,0,0,0.0,0.5
2021-04-05,1,0,1,0.060040101408958435,0.060040101408958435
2021-04-06,0,1,1,0.9491415619850159,0.9491415619850159
2021-04-07,3,3,6,3.0449451208114624,0.507490853468577
2021-04-08,0,1,1,0.9491415619850159,0.9491415619850159
2021-04-09,0,0,0,0.0,0.5
2021-04-10,0,1,1,0.9265757203102112,0.9265757203102112
2021-04-11,0,0,0,0.0,0.5
2021-04-12,0,1,1,0.8271816372871399,0.8271816372871399
2021-04-13,0,0,0,0.0,0.5
2021-04-14,0,0,0,0.0,0.5
2021-04-15,0,0,0,0.0,0.5
2021-04-16,0,0,0,0.0,0.5
2021-04-17,0,0,0,0.0,0.5
2021-04-18,0,1,1,0.975623369216919,0.975623369216919
2021-04-19,0,4,4,2.6819450855255127,0.6704862713813782
2021-04-20,1,2,3,1.5075175240635872,0.502505841354529
2021-04-21,0,2,2,1.1494338512420654,0.5747169256210327
2021-04-22,0,1,1,0.5747169256210327,0.5747169256210327
2021-04-23,0,0,0,0.0,0.5
2021-04-24,0,0,0,0.0,0.5
2021-04-25,2,0,2,0.6691810786724091,0.33459053933620453
2021-04-26,0,0,0,0.0,0.5
2021-04-27,0,0,0,0.0,0.5
2021-04-28,1,1,2,0.9426497220993042,0.4713248610496521
2021-04-29,1,0,1,0.02837355062365532,0.02837355062365532
2021-04-30,1,2,3,1.9730130732059479,0.6576710244019827
2021-05-01,0,0,0,0.0,0.5
2021-05-02,0,1,1,0.8173611760139465,0.8173611760139465
2021-05-03,3,0,3,0.04693331569433212,0.015644438564777374
2021-05-04,3,9,12,6.3800939209759235,0.5316744934146603
2021-05-05,2,3,5,2.8158543836325407,0.5631708767265081
2021-05-06,1,11,12,9.201346956193447,0.7667789130161206
2021-05-07,0,9,9,6.83924400806427,0.75991600089603
2021-05-08,1,3,4,2.1693547666072845,0.5423386916518211
2021-05-09,0,0,0,0.0,0.5
2021-05-10,0,1,1,0.9556851983070374,0.9556851983070374
2021-05-11,0,2,2,1.8697401285171509,0.9348700642585754
2021-05-12,0,1,1,0.9538055062294006,0.9538055062294006
2021-05-13,0,1,1,0.5747169256210327,0.5747169256210327
2021-05-14,1,0,1,0.0071894507855176926,0.0071894507855176926
2021-05-15,0,0,0,0.0,0.5
2021-05-16,0,0,0,0.0,0.5
2021-05-17,0,1,1,0.9769273996353149,0.9769273996353149
2021-05-18,0,1,1,0.949196994304657,0.949196994304657
2021-05-19,0,1,1,0.7997959852218628,0.7997959852218628
2021-05-20,0,0,0,0.0,0.5
2021-05-21,0,1,1,0.7643330693244934,0.7643330693244934
2021-05-22,0,0,0,0.0,0.5
2021-05-23,0,1,1,0.9847250580787659,0.9847250580787659
2021-05-24,1,1,2,0.9909017961472273,0.49545089807361364
2021-05-25,0,1,1,0.8970041871070862,0.8970041871070862
2021-05-26,0,1,1,0.954177737236023,0.954177737236023
2021-05-27,1,1,2,0.842876486480236,0.421438243240118
2021-05-28,3,8,11,6.588943023234606,0.598994820294055
2021-05-29,1,5,6,4.07828120328486,0.6797135338808099
2021-05-30,0,0,0,0.0,0.5
2021-05-31,0,2,2,1.5472227334976196,0.7736113667488098
2021-06-01,0,0,0,0.0,0.5
2021-06-02,0,0,0,0.0,0.5
2021-06-03,0,1,1,0.8347525000572205,0.8347525000572205
2021-06-04,0,0,0,0.0,0.5
2021-06-05,0,0,0,0.0,0.5
2021-06-06,0,0,0,0.0,0.5
2021-06-07,0,0,0,0.0,0.5
2021-06-08,0,0,0,0.0,0.5
2021-06-09,0,1,1,0.6354089975357056,0.6354089975357056
2021-06-10,0,0,0,0.0,0.5
2021-06-11,22,1,23,10.636075019836426,0.46243804434071417
2021-06-12,1,2,3,1.4004923179745674,0.4668307726581891
2021-06-13,0,0,0,0.0,0.5
2021-06-14,0,0,0,0.0,0.5
2021-06-15,0,4,4,3.3914012908935547,0.8478503227233887
2021-06-16,0,0,0,0.0,0.5
2021-06-17,1,0,1,0.00716056115925312,0.00716056115925312
2021-06-18,1,0,1,0.026885544881224632,0.026885544881224632
2021-06-19,2,0,2,0.0662295687943697,0.03311478439718485
2021-06-20,0,0,0,0.0,0.5
2021-06-21,1,0,1,0.0890614464879036,0.0890614464879036
2021-06-22,1,2,3,2.285334825515747,0.7617782751719157
2021-06-23,1,0,1,0.31896981596946716,0.31896981596946716
2021-06-24,1,4,5,3.604742876254022,0.7209485752508045
2021-06-25,0,11,11,9.179118752479553,0.8344653411345049
2021-06-26,0,1,1,0.8629822134971619,0.8629822134971619
2021-06-27,0,1,1,0.5747169256210327,0.5747169256210327
2021-06-28,0,0,0,0.0,0.5
2021-06-29,1,0,1,0.03156560659408569,0.03156560659408569
2021-06-30,2,1,3,0.9328545667231083,0.3109515222410361
2021-07-01,0,0,0,0.0,0.5
2021-07-02,0,0,0,0.0,0.5
2021-07-03,0,4,4,3.000314235687256,0.750078558921814
2021-07-04,1,1,2,0.749936617910862,0.374968308955431
2021-07-05,1,2,3,1.475908737629652,0.491969579209884
2021-07-06,0,0,0,0.0,0.5
2021-07-07,2,0,2,0.058947594836354256,0.029473797418177128
2021-07-08,0,1,1,0.590230405330658,0.590230405330658
2021-07-09,2,0,2,0.10318328440189362,0.05159164220094681
2021-07-10,2,0,2,0.18384436704218388,0.09192218352109194
2021-07-11,0,2,2,1.6018624305725098,0.8009312152862549
2021-07-12,0,0,0,0.0,0.5
2021-07-13,2,0,2,0.3953402955085039,0.19767014775425196
2021-07-14,0,1,1,0.9086636304855347,0.9086636304855347
2021-07-15,2,0,2,0.06271170638501644,0.03135585319250822
2021-07-16,1,0,1,0.0048514422960579395,0.0048514422960579395
2021-07-17,0,0,0,0.0,0.5
2021-07-18,0,0,0,0.0,0.5
2021-07-19,0,1,1,0.5728533864021301,0.5728533864021301
2021-07-20,0,0,0,0.0,0.5
2021-07-21,0,0,0,0.0,0.5
2021-07-22,0,0,0,0.0,0.5
2021-07-23,2,0,2,0.11584517545998096,0.05792258772999048
2021-07-24,1,0,1,0.10557112097740173,0.10557112097740173
2021-07-25,1,3,4,2.409947868436575,0.6024869671091437
2021-07-26,1,0,1,0.006435653660446405,0.006435653660446405
2021-07-27,3,2,5,1.808453693985939,0.3616907387971878
2021-07-28,4,1,5,1.491371687501669,0.2982743375003338
2021-07-29,5,2,7,2.107378102838993,0.30105401469128473
2021-07-30,6,4,10,4.1809610007330775,0.4180961000733078
2021-07-31,7,17,24,14.179705368354917,0.5908210570147882
2021-08-01,39,15,54,19.504810714162886,0.36120019841042383
2021-08-02,7,4,11,4.363303645979613,0.39666396781632846
2021-08-03,4,2,6,1.79449000954628,0.2990816682577133
2021-08-04,12,5,17,4.936692886054516,0.2903936991796774
2021-08-05,24,61,85,51.30825190991163,0.6036264930577839
2021-08-06,15,16,31,14.445296127349138,0.46597729443061736
2021-08-07,10,11,21,8.84401140641421,0.4211434003054386
2021-08-08,2,16,18,13.619626104831696,0.756645894712872
2021-08-09,6,8,14,7.202632401604205,0.514473742971729
2021-08-10,11,6,17,7.285349934827536,0.42854999616632566
2021-08-11,13,19,32,16.963922884315252,0.5301225901348516
2021-08-12,7,36,43,29.68691746890545,0.6903934295094291
2021-08-13,11,3,14,3.641577608883381,0.2601126863488129
2021-08-14,5,2,7,1.7856896133162081,0.25509851618802976
2021-08-15,9,0,9,1.3148675030097365,0.14609638922330406
2021-08-16,7,3,10,2.775626833550632,0.2775626833550632
2021-08-17,3,2,5,1.8941603526473045,0.3788320705294609
2021-08-18,3,4,7,3.823445774614811,0.5462065392306873
2021-08-19,7,6,13,5.805698521435261,0.4465921939565585
2021-08-20,16,13,29,12.878825658466667,0.4440974364988506
2021-08-21,9,4,13,3.7718866169452667,0.29014512438040513
2021-08-22,2,1,3,0.8026450760662556,0.2675483586887519
2021-08-23,3,2,5,2.037427027709782,0.40748540554195645
2021-08-24,3,2,5,1.5895211538299918,0.3179042307659984
2021-08-25,2,3,5,2.7891001105308533,0.5578200221061707
2021-08-26,5,2,7,2.5352816842496395,0.3621830977499485
2021-08-27,2,3,5,2.9664906729012728,0.5932981345802546
2021-08-28,2,4,6,3.5464102630503476,0.5910683771750579
2021-08-29,1,1,2,0.9480933747254312,0.4740466873627156
2021-08-30,0,1,1,0.9052342772483826,0.9052342772483826
2021-08-31,1,2,3,1.9061331450939178,0.6353777150313059
2021-09-01,3,5,8,4.402666197391227,0.5503332746739034
2021-09-02,6,3,9,3.2878103079274297,0.3653122564363811
2021-09-03,3,2,5,1.6613948419690132,0.33227896839380267
2021-09-04,3,1,4,1.2953123857732862,0.32382809644332156
2021-09-05,1,0,1,0.31238386034965515,0.31238386034965515
2021-09-06,1,0,1,0.08056905120611191,0.08056905120611191
2021-09-07,1,0,1,0.2372002899646759,0.2372002899646759
2021-09-08,1,0,1,0.4931914508342743,0.4931914508342743
2021-09-09,2,0,2,0.054348303470760584,0.027174151735380292
2021-09-10,3,1,4,1.4138945937156677,0.35347364842891693
2021-09-11,1,2,3,1.9804142862558365,0.6601380954186121
2021-09-12,0,1,1,0.9367280006408691,0.9367280006408691
2021-09-13,1,3,4,2.8570611756294966,0.7142652939073741
2021-09-14,2,3,5,2.7190416902303696,0.5438083380460739
2021-09-15,0,6,6,5.066830337047577,0.8444717228412628
2021-09-16,0,2,2,1.8796786665916443,0.9398393332958221
2021-09-17,1,0,1,0.005687284749001265,0.005687284749001265
2021-09-18,1,2,3,1.7916652467101812,0.5972217489033937
2021-09-19,2,1,3,1.3794701807200909,0.4598233935733636
2021-09-20,0,1,1,0.5342925786972046,0.5342925786972046
2021-09-21,0,0,0,0.0,0.5
2021-09-22,0,0,0,0.0,0.5
2021-09-23,3,0,3,0.08102959580719471,0.027009865269064903
2021-09-24,2,0,2,0.2023792862892151,0.10118964314460754
2021-09-25,2,0,2,0.5567400455474854,0.2783700227737427
2021-09-26,10,2,12,2.7271361500024796,0.22726134583353996
2021-09-27,9,17,26,14.62399553693831,0.5624613668053196
2021-09-28,2,1,3,0.9118206901475787,0.3039402300491929
2021-09-29,7,4,11,4.115670352242887,0.3741518502038988
2021-09-30,2,3,5,2.9559323862195015,0.5911864772439003
2021-10-01,3,4,7,3.570061156526208,0.5100087366466012
2021-10-02,4,0,4,0.5252170921303332,0.1313042730325833
2021-10-03,2,0,2,0.1376126930117607,0.06880634650588036
2021-10-04,0,3,3,1.990662157535553,0.663554052511851
2021-10-05,0,2,2,1.733213186264038,0.866606593132019
2021-10-06,1,1,2,0.5666549848392606,0.2833274924196303
2021-10-07,2,2,4,1.9154037861153483,0.4788509465288371
2021-10-08,1,0,1,0.005957763642072678,0.005957763642072678
2021-10-09,1,2,3,1.7916568908840418,0.597218963628014
2021-10-10,0,1,1,0.9483197331428528,0.9483197331428528
2021-10-11,1,2,3,1.6852152571082115,0.5617384190360705
2021-10-12,1,1,2,0.9950603526085615,0.49753017630428076
2021-10-13,1,0,1,0.04541672766208649,0.04541672766208649
2021-10-14,1,0,1,0.34671515226364136,0.34671515226364136
2021-10-15,1,0,1,0.3972046673297882,0.3972046673297882
2021-10-16,1,0,1,0.02273580990731716,0.02273580990731716
2021-10-17,4,0,4,0.4031244311481714,0.10078110778704286
2021-10-18,10,14,24,12.231908619403839,0.5096628591418266
2021-10-19,40,23,63,23.3804067238234,0.37111756704481585
2021-10-20,27,54,81,43.749280735850334,0.5401145769858066
2021-10-21,23,23,46,18.645449012052268,0.40533584808809275
2021-10-22,2,2,4,1.5439931340515614,0.38599828351289034
2021-10-23,15,2,17,2.334108372218907,0.1373004924834651
2021-10-24,8,15,23,12.425940648652613,0.5402582890718527
2021-10-25,11,8,19,9.106892500072718,0.47931013158277463
2021-10-26,11,8,19,8.52436899766326,0.4486509998770137
2021-10-27,6,15,21,13.175685226917267,0.6274135822341556
2021-10-28,1,10,11,8.294778488576412,0.7540707716887648
2021-10-29,3,8,11,6.747661180794239,0.6134237437085672
2021-10-30,2,5,7,3.7888047136366367,0.5412578162338052
2021-10-31,2,1,3,1.150348206050694,0.383449402016898
2021-11-01,2,0,2,0.09669288247823715,0.048346441239118576
2021-11-02,2,10,12,7.940248668193817,0.6616873890161514
2021-11-03,0,6,6,5.301671922206879,0.8836119870344797
2021-11-04,3,23,26,15.270803447812796,0.587338594146646
2021-11-05,4,2,6,2.572050206363201,0.42867503439386684
2021-11-06,2,2,4,2.1074347272515297,0.5268586818128824
2021-11-07,0,1,1,0.7584903836250305,0.7584903836250305
2021-11-08,5,2,7,1.9423036999069154,0.27747195712955935
2021-11-09,2,5,7,4.23016841430217,0.6043097734717386
2021-11-10,0,3,3,2.3263702988624573,0.7754567662874857
2021-11-11,2,3,5,2.7922174260020256,0.5584434852004051
2021-11-12,6,0,6,0.6803964292630553,0.11339940487717588
2021-11-13,2,2,4,2.251271054148674,0.5628177635371685
2021-11-14,1,2,3,2.2970166206359863,0.7656722068786621
2021-11-15,1,1,2,1.153993546962738,0.576996773481369
2021-11-16,2,8,10,7.137159248813987,0.7137159248813987
2021-11-17,0,0,0,0.0,0.5
2021-11-18,1,1,2,0.9032861664891243,0.45164308324456215
2021-11-19,2,2,4,1.6155077731236815,0.4038769432809204
2021-11-20,1,1,2,0.991422213613987,0.4957111068069935
2021-11-21,2,1,3,1.083725530654192,0.3612418435513973
2021-11-22,2,2,4,1.231831420212984,0.307957855053246
2021-11-23,1,6,7,5.401019167155027,0.7715741667364325
2021-11-24,17,38,55,29.7697515017353,0.54126820912246
2021-11-25,4,10,14,8.990009188652039,0.6421435134751456
2021-11-26,0,2,2,1.5793228149414062,0.7896614074707031
2021-11-27,1,0,1,0.15561766922473907,0.15561766922473907
2021-11-28,1,1,2,1.0018393713980913,0.5009196856990457
2021-11-29,2,0,2,0.4269529730081558,0.2134764865040779
2021-11-30,1,3,4,2.8652782142162323,0.7163195535540581
2021-12-01,2,1,3,0.8558408534154296,0.28528028447180986
2021-12-02,0,0,0,0.0,0.5
2021-12-03,2,2,4,1.5400125533342361,0.38500313833355904
2021-12-04,0,2,2,1.5217419862747192,0.7608709931373596
2021-12-05,0,4,4,3.41110098361969,0.8527752459049225
2021-12-06,2,0,2,0.40594083443284035,0.20297041721642017
2021-12-07,2,1,3,0.9220764376223087,0.3073588125407696
2021-12-08,1,3,4,3.0193288922309875,0.7548322230577469
2021-12-09,0,0,0,0.0,0.5
2021-12-10,1,1,2,0.6848580623045564,0.3424290311522782
2021-12-11,2,0,2,0.4723985493183136,0.2361992746591568
2021-12-12,2,2,4,1.4331087619066238,0.35827719047665596
2021-12-13,4,1,5,1.4986908342689276,0.2997381668537855
2021-12-14,0,0,0,0.0,0.5
2021-12-15,4,5,9,3.8911296725273132,0.43234774139192367
2021-12-16,2,6,8,5.05883720330894,0.6323546504136175
2021-12-17,126,87,213,79.1392862861976,0.37154594500562255
2021-12-18,11,4,15,5.0686264941468835,0.33790843294312556
2021-12-19,8,15,23,12.02807416394353,0.5229597462584143
2021-12-20,710,203,913,222.84856680058874,0.2440838628703053
2021-12-21,653,138,791,159.24997826502658,0.2013274061504761
2021-12-22,378,185,563,176.9982599695213,0.3143841207273913
2021-12-23,165,115,280,114.52473929617554,0.4090169260577698
2021-12-24,57,55,112,49.977718967944384,0.44622963364236057
2021-12-25,43,24,67,25.836363185662776,0.38561736098004146
2021-12-26,44,17,61,20.97645893972367,0.34387637606104376
2021-12-27,33,108,141,88.08652846049517,0.6247271522020934
2021-12-28,38,21,59,18.44598311604932,0.3126437816279546
2021-12-29,22,11,33,11.738682731520385,0.35571765853092074
2021-12-30,19,9,28,7.992150108329952,0.2854339324403554
2021-12-31,16,2,18,2.9554615621455014,0.1641923090080834
